{
  "episode_0": [
    "0000000",
    "0130340",
    "0140140",
    "0410110",
    "0110110",
    "0110110",
    "0310110",
    "0410310",
    "I000000"
  ],
  "episode_0": [
    "000000200",
    "000040400",
    "000400000",
    "000400030",
    "000400000",
    "0004I0000"
  ],
  "episode_1": [
    "000000400",
    "000000400",
    "000300000",
    "000300020",
    "000300000",
    "0004I0000"
  ],
  "episode_2": [
    "000000200",
    "000040400",
    "000300000",
    "000400040",
    "000200000",
    "0004I0000"
  ],
  "episode_3": [
    "000000200",
    "000030400",
    "000400000",
    "000400030",
    "000300000",
    "0003I0000"
  ],
  "episode_4": [
    "000000400",
    "000040400",
    "000400000",
    "000400040",
    "000200000",
    "0004I0000"
  ],
  "episode_5": [
    "000000400",
    "000040200",
    "000300000",
    "000400030",
    "000400000",
    "0004I0000"
  ],
  "episode_6": [
    "000000400",
    "000000400",
    "000200000",
    "000300040",
    "000400000",
    "0003I0000"
  ],
  "episode_7": [
    "000000400",
    "000040400",
    "000400000",
    "000200030",
    "000200000",
    "0004I0000"
  ],
  "episode_8": [
    "000000400",
    "000040400",
    "000300000",
    "000400040",
    "000200000",
    "0003I0000"
  ],
  "episode_9": [
    "000000200",
    "000000400",
    "000300000",
    "000400030",
    "000200000",
    "0004I0000"
  ],
  "episode_10": [
    "000000200",
    "000040400",
    "000300000",
    "000400040",
    "000400000",
    "0003I0000"
  ],
  "episode_11": [
    "000000400",
    "000040200",
    "000300000",
    "000400030",
    "000400000",
    "0003I0000"
  ],
  "episode_12": [
    "000000400",
    "000000400",
    "000200000",
    "000300040",
    "000400000",
    "0003I0000"
  ],
  "episode_13": [
    "000000200",
    "000000400",
    "000300000",
    "000400030",
    "000200000",
    "0004I0000"
  ],
  "episode_14": [
    "000000400",
    "000040400",
    "000400000",
    "000200030",
    "000200000",
    "0004I0000"
  ],
  "episode_15": [
    "000000200",
    "000030400",
    "000400000",
    "000400030",
    "000300000",
    "0003I0000"
  ],
  "episode_16": [
    "000000400",
    "000040400",
    "000300000",
    "000400040",
    "000200000",
    "0003I0000"
  ],
  "episode_17": [
    "000000400",
    "000040400",
    "000400000",
    "000400040",
    "000200000",
    "0004I0000"
  ],
  "episode_18": [
    "000000400",
    "000000400",
    "000300000",
    "000300020",
    "000300000",
    "0004I0000"
  ],
  "episode_19": [
    "000000200",
    "000040400",
    "000400000",
    "000300030",
    "000400000",
    "0002I0000"
  ]
}